wwwwwwwwwwwwwww
wh   b h b   hw
w bbbb   bbbb w
w s    b    s w
w b bb   bb bbw
w b g  s  g sbw
w   ggggggg  bw
w s ggggggg  bw
wbs g  s  g b w
wbb bb   bb s w
wbs    b    b w
wbbbbb   bbbb w
wbb   bbb   b w
wbb  pbeb     w
wwwwwwwwwwwwwww