wwwwwwwwwwwwwww
whb b bhb b bhw
w b b b b b b w
w s s s s s s w
w    b   b    w
wb bbb b bbb bw
ws s s s s s sw
wgg  b g b  ggw
wggggbbgbbggggw
wgggggggggggggw
wb b bgggb b bw
w b b  g  b b w
w b b bbb b b w
w b bpbeb b b w
wwwwwwwwwwwwwww