wwwwwwwwwwwwwww
wh  b   h  g hw
wb      g s   w
w    g s   g  w
w   s   g     w
w    g        w
wsb g g  g gbsw
w    s    s   w
w   g g  g g  w
w             w
wb   s    s  bw
wb  g g  g g bw
w b   bbb  b  w
w bb pbeb bb  w
wwwwwwwwwwwwwww