wwwwwwwwwwwwwww
wh  a bh b b hw
w        b s  w
w   a bs b b  w
ws ba s b  b  w
w  ba   b     w
wb baa aaaa  bw
w   b   g a ssw
wbbbb sggga   w
wb    bggga bbw
w     b g a b w
w s         g w
w b s bbb agggw
w    pbeb agggw
wwwwwwwwwwwwwww