wwwwwwwwwwwwwww
wh  b  hs    hw
w b s   b b b w
w b    bb bsb w
w   b     s b w
wg  b  s  bgbsw
wgg   bgb  gggw
wgbbbggg   gb w
w   sgb b b b w
wsb s b b   b w
w b b bbb bsb w
w b b         w
w b   bbb b b w
w b bpbeb bbb w
wwwwwwwwwwwwwww


