wwwwwwwwwwwwwww
wh      hss  hw
w  ssss     s w
w  s    g sss w
w  s   gs   s w
w     gss     w
w    gsss s   w
w  s ss   ss  w
w  s  s sss   w
ws      ssg s w
w  ss   sg ss w
w  s    g  s  w
w     bbb   ssw
wss  pbeb     w
wwwwwwwwwwwwwww