wwwwwwwwwwwwwww
wh    bbh ss hw
ws  b   b     w
wb  bbb bb a aw
w     b    a  w
w   b aa aaa bw
wbbb  ab b    w
w     a     s w
waaaa a s b s w
w           sbw
wbb   bbbbb   w
w         bb  w
wbbb   bbb bb w
wbb   pbeb    w
wwwwwwwwwwwwwww